NO ./textures/jmyao.xpm
SO ./textures/jmyao.xpm
WE ./textures/wefuk/muha.xpm
EA ./textures/wefuk/alien_tymr.xpm

F 75,108,87
C 173,216,230

        1111111111111111111111111
111111111011000000100000111
101100000111000000000000111
101100000000000000000100111
111111111011000001110000111
100000000011000001110111111
111101111111110111000000001
111101111111110111010000001
110000001101010111000001001
100000000000000111000001001
100000000000000000000101001
1100000111010001111101110E1
111101111110101101111010001
111111111111111111111111111
